 #############
##...........#
#d...........#
##...........#
 #...........#
 #############