##########
#........#     ###################
#........#     #.................#
#........#     #.................#
#........#######.................#
#........|.....|.................#
#........#######.................#
#........#     #.................#
#........#     #.................#
#........#     #.................#
##########     ###########|#######
                         #.#     
                         #.#     
         #################|##############
         #..............................#
         #..............................#
         #..............................#
         #..............................#
         #..............................#
         #..............................#
         #..............................|
         #..............................#
         ################################