##########
#......R.#     ###################
#........#     #.................#
#.@......#     #.................#
#........#######.................#
#........|.....|.................#
#........#######.................#
#....R...#     #..........R......#
#........#     #.................#
#........#     #.................#
##########     ###########|#######
                         #.#     
                         #.#     
         #################|################################
         #................................................#
         #......................................R.........#
         #................................................#
         #....S...........................................#
         #................................................#
         #.............S..................................#
         #................................................|
         #................................................#
         #................................................#
         #.....................................S..........#
         #................................................#
         ####|#############################################
            #.#
            #.#
            #.#
            #.#
            #.#####
            #.....#
            #.....#
            #######
         