##########
#........#     ###################
#........#     #.................#
#........#     #.................#
#........#######.................#              ###
#........|.....|.................#          #####u#
#........#######.................#          #.@...#
#........#     #..........R......#          #.....#
#........#     #.................#          ##|####
#........#     #.................#           #.#
##########     ####|##############           #.#
                  #.#                        #.#   
                  #.#                        #.#   
         ##########|##########################.############
         #................................................#
         #......................................R.........#
         #................................................#
         #....S...........................................#
         #................................................#
         #...............................S................#
         #................................................#
         #.......................S........................#
         #................................................#
         #................................................#
         #................................................#
         ####|#############################################
            #.#
            #.#
            #.#
            #.#
            #.#####
            #.....#
            #..S..#
            #######
         