##########
#........#     ###################
#........#     #.................#
#........#     #.................#
#........#######.................#
#...@....|.....|.................#
#........#######.................#
#........#     #..........R......#
#........#     #.................#
#........#     #.................#
##########     ####|##############
                  #.#            
                  #.#            
         ##########|#######################################
         #................................................#
         #......................................R.........#
         #................................................#
         #....S...........................................#
         #................................................#
         #.............S..................................#
         #................................................|
         #................................................#
         #................................................#
         #.....................................S..........#
         #................................................#
         ####|#############################################
            #.#
            #.#
            #.#
            #.#
            #.#####
            #.....#
            #.....#
            #######
         