##########
#........#   #######
#........#   #.....#
#........#   #.....#
#........#####.....#
#........|...|.....#
#........#####.....#
##########   #######