##########
#........#     ###################
#........#     #.................#
#........#     #.................#
#........#######.................#
#........|.....|.................#
#........#######.................#
#........#     #.................#
#........#     #.................#
#........#     #.................#
##########     ###########|#######
                         #.#     
                         #.#     
         #################|################
         #................................#
         #................................#
         #................................#
         #................................#
         #................................#
         #................................#
         #................................|
         #................................#
         #................................#
         ##################################