#############
#...........#
d...........#
#...........#
#...........#
#############